11,11,11,11,11,11,11,11,11,11,11,11,11,11,11,11,11,11,11,11,11,11,11,11,11
11,11,11,11,11,11,11,11,11,11,11,11,11,11,11,11,11,11,11,11,11,11,11,11,11
11,11,11,11,11,11,11,11,11,11,11,11,11,11,11,11,11,11,11,11,11,11,11,11,11
11,11,-1,-1,11,11,11,11,11,11,11,11,11,11,11,11,11,11,11,11,11,-1,-1,11,11
11,-1,-1,-1,-1,-1,-1,11,11,11,11,11,11,11,11,11,11,11,-1,-1,-1,-1,-1,-1,11
11,-1,1020202,-1,-1,-1,-1,-1,-1,-1,11,11,11,11,11,-1,-1,-1,-1,-1,-1,-1,1200303,-1,11
11,11,11,11,-1,-1,-1,-1,-1,-1,-1,-1,-1,-1,-1,-1,-1,-1,-1,-1,-1,11,11,11,11
11,11,11,11,11,11,11,-1,-1,-1,-1,-1,-1,-1,-1,-1,-1,-1,11,11,11,11,11,11,11
11,11,11,11,11,11,11,11,11,11,-1,-1,1100204,-1,-1,11,11,11,11,11,11,11,11,11,11
11,11,11,11,11,11,11,11,11,11,11,11,11,11,11,11,11,11,11,11,11,11,11,11,11
caves