11,11,11,11,11,11,11,11,11,11,11,11,11,11,11,11,11,11,11,11
11,11,-1,-1,-1,-1,-1,-1,-1,-1,-1,-1,-1,-1,-1,-1,-1,-1,11,11
11,-1,-1,-1,-1,-1,-1,-1,-1,-1,-1,-1,-1,-1,-1,-1,-1,-1,-1,11
11,-1,-1,-1,-1,-1,-1,-1,-1,-1,-1,-1,-1,-1,-1,-1,-1,-1,-1,11
11,-1,-1,-1,-1,-1,-1,12,12,12,-1,-1,-1,-1,-1,-1,-1,-1,-1,11
11,-1,-1,-1,-1,11,11,11,11,11,11,-1,-1,-1,-1,-1,-1,-1,-1,11
11,-1,-1,-1,11,11,11,11,11,11,11,11,11,-1,-1,-1,-1,-1,-1,11
11,-1,-1,-1,10,10,10,-1,-1,11,11,11,11,11,11,-1,-1,-1,-1,11
11,11,1040303,-1,-1,-1,12,12,12,-1,11,11,11,11,11,11,11,1100503,11,11
11,11,11,11,11,11,11,11,11,11,11,11,11,11,11,11,11,11,11,11
caves